15 30
##############################
#                            #
#                            #
#                  ##        #
#                   ##       #
#                    ##      #
#            ##              #
#          ####              #
#        #####               #
#         ###                #
#                    ###     #
#                    #       #
#                    #       #
#                            #
##############################